WWWWWWWWWW
W WWWWWW W
W        W
W        W
W WWWWWW W
W WWWWWW W
WWWWWWWWWW