WWWWWWWWWW
W      W W
WW WW  W W
W   W  W W
W W WWWW W
W W      W
WWWWWWWWWW