WWWWW
W W W
W   W
W   W
W W W
W W W
WWWWW