WWWWWWW
W     W
W XXX W
W X X W
W X X W
W     W
WWWWWWW
