WWWWWWW
W     W
W XWWXW
W     W
WXWWX W
W     W
WWWWWWW
