WWWWWWWWWWWWWWWWWWWWWWWWWWWWWWW
W                             W
W                             W
WXWWWWWWWWWWWWWWWWWWWWX       W
W                             W
W                             W
W       XWWWWWWWWWWWWWWWWWWWWXW
W                             W
W                             W
WXWWWWWWWWWWWWWWWWWWWWX       W
W                             W
W                             W
W       XWWWWWWWWWWWWWWWWWWWWXW
W                             W
W                             W
WXWWWWWWWWWWWWWWWWWWWWX       W
W                             W
W                             W
W       XWWWWWWWWWWWWWWWWWWWWXW
W                             W
W                             W
WXWWWWWWWWWWWWWWWWWWWWX       W
W                             W
W                             W
W       XWWWWWWWWWWWWWWWWWWWWXW
W                             W
W                             W
WXWWWWWWWWWWWWWWWWWWWWX       W
W                             W
W                             W
WWWWWWWWWWWWWWWWWWWWWWWWWWWWWWW
