WWWWWWWWWWWWWWWWWWWWWWWWWWWWWWW
W                             W
W    WWWWWWWWWWWWWWWWWWWWWWWWWW
W                             W
WWWWWWWWWWWWWWWWWWWWWWWWWW    W
W                             W
W    WWWWWWWWWWWWWWWWWWWWWWWWWW
W                             W
WWWWWWWWWWWWWWWWWWWWWWWWWW    W
W                             W
W    WWWWWWWWWWWWWWWWWWWWWWWWWW
W                             W
WWWWWWWWWWWWWWWWWWWWWWWWWW    W
W                             W
W    WWWWWWWWWWWWWWWWWWWWWWWWWW
W                             W
WWWWWWWWWWWWWWWWWWWWWWWWWW    W
W                             W
W    WWWWWWWWWWWWWWWWWWWWWWWWWW
W                             W
WWWWWWWWWWWWWWWWWWWWWWWWWW    W
W                             W
W    WWWWWWWWWWWWWWWWWWWWWWWWWW
W                             W
WWWWWWWWWWWWWWWWWWWWWWWWWW    W
W                             W
W    WWWWWWWWWWWWWWWWWWWWWWWWWW
W                             W
WWWWWWWWWWWWWWWWWWWWWWWWWW    W
W                             W
WWWWWWWWWWWWWWWWWWWWWWWWWWWWWWW
