WWWWWWW
W     W
W WWWWW
W     W
WWWWW W
W     W
WWWWWWW
