WWWWWWW
WEEEEEW
WEEEEEW
WEEEEEW
WEEEEEW
WEEEEGW
WWWWWWW

WWWWWWW
WEEEEEW
WEEEEEW
WEEEEEW
WEEEEEW
WEEEEGW
WWWWWWW
