WWWWWWW
WEEWEEW
WEEWGEW
WEEWEEW
WEEEEEW
WEEWEEW
WWWWWWW

WWWWWWW
WEEWEEW
WEEWGEW
WEEWEEW
WEEEEEW
WEEWEEW
WWWWWWW
