WWWWWWW
WEWEEEW
WEWEGEW
WEWEEEW
WEEEEEW
WEWEEEW
WWWWWWW

WWWWWWW
WEWEEEW
WEWEGEW
WEWEEEW
WEEEEEW
WEWEEEW
WWWWWWW
