WWWWWWW
WEEEEEW
WEEEEEW
WEEGEEW
WEEEEEW
WEEEEEW
WWWWWWW

WWWWWWW
WEEEEEW
WEEEEEW
WEEGEEW
WEEEEEW
WEEEEEW
WWWWWWW
