WWWWWWW
WEEEEEW
WEEEEEW
WEEEEEW
WEEEEEW
WEEGEEW
WWWWWWW

WWWWWWW
WEEEEEW
WEEEEEW
WEEEEEW
WEEEEEW
WEEGEEW
WWWWWWW
